20 20
00 01 01 01 01 01 01 01 01 01 01 01 01 01 01 01 01 01 01 02
12 22 22 22 22 22 22 22 22 22 22 22 22 22 22 22 22 22 22 14
12 22 22 22 22 22 22 22 22 22 22 22 22 22 22 22 22 22 22 14
12 22 22 22 22 22 22 22 22 22 22 22 22 22 22 22 22 22 22 14
12 22 22 22 22 22 22 22 22 22 22 22 22 22 22 22 22 22 22 14
12 22 22 22 22 22 22 22 22 22 22 22 22 22 22 22 22 22 22 14
12 22 22 22 22 22 22 22 22 22 22 22 22 22 22 22 22 22 22 14
12 22 22 22 22 22 22 22 22 22 22 22 22 22 22 22 22 22 22 14
12 22 22 22 22 22 22 22 22 22 22 22 22 22 22 22 22 22 22 14
12 22 22 22 22 22 22 22 22 22 22 22 22 22 22 22 22 22 22 14
12 22 22 22 22 22 22 22 22 22 22 22 22 22 22 22 22 22 22 14
12 22 22 22 22 22 22 22 22 22 22 22 22 22 22 22 22 22 22 14
12 22 22 22 22 22 22 22 22 22 22 22 22 22 22 22 22 22 22 14
12 22 22 22 22 22 22 22 22 22 22 22 22 22 22 22 22 22 22 14
12 22 22 22 22 22 22 22 22 22 22 22 22 22 22 22 22 22 22 14
12 22 22 22 22 22 22 22 22 22 22 22 22 22 22 22 22 22 22 14
12 22 22 22 22 22 22 22 22 22 22 22 22 22 22 22 22 22 22 14
12 22 22 22 22 22 22 22 22 22 22 22 22 22 22 22 22 22 22 14
12 22 22 22 22 22 22 22 22 22 22 22 22 22 22 22 22 22 22 14
24 25 25 25 25 25 25 25 25 25 25 25 25 25 25 25 25 25 25 26